..........................
..........................
..@@@@@@@@@@@@@@@@@@@@@@@@
..@.......................
..@.......................
..@.......................
..@.......................
..@.......................
..@.......................
..@.......................
..@.......................
..@.......................
..@.......................
..@.......................
..@.......................
..@.......................
..@.......................
..@.......................
..@.......................
..@.......................
..@.......................
..@.......................
..@.......................
..@@@@@@@@@@@##...##..##..
...........@..#...######..
...........@..#...######..
